001 001 003 017 020 037 010 010 010 010 010 015 015 038 028 028 007 007 007 
001 001 003 017 020 037 010 010 010 010 010 015 015 038 038 028 007 007 007
001 001 003 017 020 037 010 010 010 010 010 015 015 038 038 028 007 007 007
001 001 003 017 005 037 010 010 010 010 010 015 015 038 038 028 007 007 007
001 001 003 017 017 016 016 010 017 010 017 015 015 038 038 028 007 007 007
001 001 003 017 017 016 016 016 017 017 017 015 015 038 038 028 007 007 007
001 003 003 017 017 016 016 016 017 017 017 015 015 038 038 028 028 007 007
001 001 003 017 017 016 016 016 017 017 017 015 015 038 038 028 028 007 007
001 001 003 017 017 016 016 016 017 017 017 015 015 038 038 028 028 007 007
001 001 003 017 005 016 016 016 028 028 028 015 015 038 038 028 028 007 007
001 001 003 017 005 016 025 025 025 028 028 015 015 038 038 028 028 007 007
001 001 003 017 005 027 006 025 025 025 006 015 015 038 038 028 028 007 007
001 001 003 017 005 006 006 006 006 006 006 015 015 038 038 028 028 007 007
001 001 003 017 005 006 006 006 006 006 006 015 015 038 038 028 028 007 007
001 001 003 017 005 006 006 006 006 006 006 015 015 038 038 028 028 007 007
001 001 003 017 005 006 006 006 006 006 006 015 015 038 038 028 028 007 007
001 001 003 017 005 006 006 006 006 006 006 015 015 038 038 028 028 007 007
001 001 003 017 005 006 006 006 006 006 006 015 015 038 038 028 028 007 007
001 001 003 017 005 006 006 006 006 006 006 015 015 038 038 028 007 007 007
