015 015 015 015 015 015 015 015 015 015 015 015 015 015 015 015 024 024 007
015 015 015 015 015 015 015 015 015 015 015 015 015 015 015 015 024 007 007
015 015 015 015 015 015 015 015 015 015 015 015 015 015 015 025 007 007 007
015 015 032 015 015 015 015 015 015 015 015 015 015 015 024 024 007 007 024
015 032 032 032 015 015 015 015 015 015 015 015 024 024 007 007 007 007 024
015 015 032 032 015 015 015 015 015 015 024 024 007 007 007 007 007 024 015
015 015 015 032 032 015 015 015 015 024 024 024 007 007 007 007 024 024 015
015 015 015 032 015 015 015 015 024 024 024 024 007 007 024 025 015 015 015
015 015 015 015 015 015 024 024 007 007 024 024 007 024 015 015 015 015 015
015 015 015 015 015 015 024 007 007 007 026 024 024 024 015 015 015 015 015
015 015 015 015 024 026 007 007 007 007 024 024 024 015 015 015 015 015 015
015 015 015 015 024 007 007 007 024 024 024 024 015 015 015 015 015 015 015
015 015 015 025 007 007 007 024 015 015 015 015 015 015 015 015 015 015 015
015 015 024 024 007 007 024 024 015 015 015 015 015 015 032 032 032 015 015
015 024 007 007 007 007 024 015 015 015 015 015 015 015 032 032 032 015 015
024 024 007 007 007 024 015 015 015 015 015 015 015 015 032 032 015 015 015
024 007 007 007 024 024 015 015 015 015 015 015 015 015 032 015 015 015 015
007 007 007 024 015 015 015 015 015 015 015 015 015 015 015 015 015 015 015
007 007 024 024 015 015 015 015 015 015 015 015 015 015 015 015 015 015 015
