016 016 016 017 005 005 005 002 001 001 000 000 000 001 013 013 006 007 007 
016 016 016 017 005 005 005 002 001 001 001 001 000 001 013 036 006 007 007
016 016 016 017 005 005 002 002 001 001 001 012 013 013 013 013 006 007 007
016 016 016 017 005 005 002 002 001 001 001 012 014 013 014 014 006 007 007
017 016 016 017 002 002 001 000 000 001 012 012 012 013 013 014 006 007 007
017 017 017 017 002 002 001 001 000 000 000 012 014 014 014 036 006 007 007
017 018 018 017 002 002 002 000 000 000 000 012 014 014 014 014 014 006 006
017 018 018 005 002 002 000 000 000 000 012 012 014 014 014 014 014 014 014
018 018 005 005 002 001 000 001 001 001 000 012 014 014 014 014 014 014 014
018 005 005 017 001 000 006 001 002 001 000 012 014 014 014 013 013 012 012
005 004 005 015 001 001 021 001 001 001 028 000 013 013 013 013 013 012 012
003 004 005 017 001 001 025 025 025 026 024 012 013 012 013 013 013 013 012
003 005 006 005 001 001 026 026 026 026 024 013 013 012 012 012 013 012 012
003 005 006 005 001 001 001 024 024 024 026 024 012 012 012 013 013 012 012
003 001 003 017 001 001 001 026 024 024 025 013 013 012 012 014 012 012 012
005 005 003 017 001 024 024 027 027 025 025 013 012 012 012 014 014 014 014
001 001 005 017 001 001 024 027 027 025 024 012 013 013 012 014 008 008 008
001 005 005 005 001 001 024 024 024 025 024 024 013 012 012 014 008 008 008
001 001 003 017 001 001 024 024 024 026 024 013 013 012 012 014 008 008 008
