017 017 003 017 020 037 010 010 010 010 010 016 015 023 023 028 017 007 007 
017 019 003 017 020 037 010 010 010 010 010 016 015 023 023 028 017 007 007
020 022 022 017 020 037 010 010 010 010 010 016 015 022 016 028 017 007 007
020 021 021 037 005 037 010 010 010 010 010 016 015 016 016 028 017 007 007
020 021 021 037 006 016 016 010 017 010 017 016 015 016 016 028 017 007 007
020 021 021 037 006 006 006 016 017 017 017 016 015 038 016 028 017 007 007
020 022 022 017 017 006 006 006 017 017 017 016 015 038 017 028 018 007 007
017 019 019 017 017 016 016 006 017 017 017 016 015 018 017 028 018 007 007
017 019 019 017 017 016 016 006 006 017 017 016 015 018 018 028 018 007 007
017 019 019 017 005 016 016 016 006 028 028 016 015 018 018 028 018 007 007
017 019 019 017 005 016 025 025 006 006 028 016 015 018 018 028 018 007 007
017 019 019 017 005 027 006 025 006 006 006 016 015 018 018 028 018 007 007
017 019 020 017 005 006 006 006 006 006 006 016 015 018 018 028 018 007 007
017 020 020 017 005 006 006 006 006 006 006 016 015 018 018 028 018 007 007
017 020 020 017 005 006 006 038 006 006 006 016 015 018 018 028 018 007 007
017 020 020 017 005 006 006 006 006 006 006 016 015 018 018 028 018 007 007
017 020 020 017 022 006 006 006 006 006 006 022 017 016 018 028 018 007 007
017 020 020 017 022 006 006 038 006 006 006 022 017 016 018 028 018 007 007
017 020 020 017 022 006 006 006 006 006 006 022 017 016 018 028 017 007 007